34/3400089
34/3400003
30/3000003
31/3103008
31/3141595
30/3000060
31/3129153
32/3224645
32/3224648
33/3359881
35/3543592
35/3543605
37/3714449
37/3714459
30/3003312
30/3003344
32/3260764
32/3260775
35/3585329
34/3495045